xvy: tps
vjj: tsf
abn: kfz
kqs: qpf uca yrb lgx pvw
jrn: qcm uzf mih xpx ibs
caq: tiq
iza: vva huc
gno: kju
bbb: jiz fxn
iru: pen khf tmk
yee: igc vdp
cge: qqs wtz fkf
aqh: leg pqv
kfm: mhd lao xvy
hzj: mbm ymz kzr
utp: cgx
dbf: iwv ffw utr inp
jzv: wzv dvp kfz
vpf: jzr pvn tsj
ufc: gui sbh
xtk: faz
rnb: sbh
hqz: pfl iki
svq: tiq qfk pka rth
mrz: yrb qpf pvw
yfw: ibs mih
zst: dmh cxd xvz
oal: kju xsb
vtl: pqv rqq leg iju
zpl: skj fgw
xam: vwz wef rpp
mtx: mbm
kgz: zfn
tsz: wzb bzl ury wjw
lko: mha umv
ojx: sbh gui
huc: aiw rnb rrn
brz: awg jxj wwe xrt zqv
puq: qil dpm xrc
bzw: oys
qhy: dgd kxn tyk
wph: kxn dgd
xlk: xam pdu kai
cvw: dtk
fnt: you
rrn: wyy you sbh ydw
ouz: hyc yda
ipr: lob bzl wzb
gaw: gcg
fli: mih uzf xpx qcm
pen: tgx zyo zaf tfb ywy
vwt: jnn qqs wtz
kwt: mfm vue
jal: tpk jdb
wbj: hzj
fhg: ufg luo svq caq koi
bgm: ndf hza
met: mha mzh umv
xiq: ras cxy qhd
zzd: fkf xal
sdh: ddy zzk
bhu: kmc rlv yda oht hyc
bzl: urt jcl qic bxk vcg cns hqz gdn vko khu fxa
kyk: ihk hje
xrc: kym bpv
uie: nhb czt pxb
cjx: joz ctu
bxk: aky
qmz: hoc mbq
luo: tiq pka qfk
hje: rxz kcr ass mqz cjf
qvm: xfc yro
jlc: whl ykk
mha: eto ffx vbq
ozz: ouz
vvu: osa cvj hva
lte: ryk rbw
wtt: out
swq: wef rpp
iki: ddy jze fgc
yrb: eno gio pgm
kar: dkg
czz: onn rsm rnu
pmj: jnn
qfk: xal jnn qqs
dej: kzr
bao: vpf ras
hcg: cgs
mfc: rez wbj
idw: zvn cvj osa
rth: xal qqs fkf
iuk: lyh gqm hcg
spq: gcg
ihp: wef vwz ych
skj: pxb czt
kju: ass
kzd: vwz rpp ych
ejy: fgw tci wyt
fgc: org xbv qrs
uzf: vje
gjp: rty
rob: jlc
mvv: fkz hho
hyc: lob wzb ury
lbv: puc mah
pji: ijl nhm
qyq: sdh
ybh: kvx wum
yza: nhb pxb czt
byt: pdu kai nfx xam
hlx: hga lfb
hek: vvu aky idw kbb
dpm: kym
fvl: tci
gdn: hlx
yzs: out
onn: kqs ogr mrz
nhm: uie qvu mvp
hml: wph qhy
nof: rpp vwz wef
xal: yqd czz egk qqv uyo pfc qvm okp fhe yrw bzd zjy zst yka zxs hjx nxy
ych: rxf bzw vhr yfw jrn blk fli gay uua pto iqh ocs izk pzx rjn lte ijc ysn dbk mvv cch dur qvq alp
yqd: iza
iqh: abn jzv
wgb: wtt hua
hey: ych vwz wef
rxf: fkz pji
oht: bzl
nxy: puq oqj fgi
xro: mmp
nhb: vtl qdh jkz cjx lqo scm met lko cwn aqh cvw whj
uua: hho pji
tps: wtz qqs jnn fkf
lfj: wzb bzl lob
szj: ill ski shw
viy: sjo rez odo
iwv: njr
zzk: org qrs
pro: zii jlc vzf
zjy: tpe puq fgi
cgd: ufg luo svq
kcr: ncg xtk vza
tpk: kgz
ejs: lob bzl wjw ury
opq: ogr mrz
cjf: ncg
zdu: mvp qvu vdn uie
hpz: joz
hgw: pxb czt nhb
xvz: jup bpf
org: swq ihp ppe
zfn: ybo
ysn: xpx ibs
jze: org
wyv: zvn osa
zaf: out
max: pww vjl xeb rob
cxd: yee jup bpf
rda: zyk ver
dtk: vwt
lpm: nhb
leg: jwm pmj lgs zzd gtt
zyo: out
pvn: lfj waf ejs
ocs: gqs rjg abn
vci: pdu
ogr: lgx yrb qpf uca
njr: hsy dif
tgx: out
dpc: you ydw gui
xlc: iuk ukx
czt: xfz vtl cjx cgd lko lqo xhf scm aqh xgj xsp cwn whj
aej: kyk
aiw: ydw gui wyy sbh
rzx: spr
pps: pji fkz
gqs: dvp
jdb: nwn
zvn: uio
gqm: pvt cgs wgb
vwz: iqh ocs dbk cch pzx rjn lte dur alp qvq pps vhr yfw bzw uua jrn ijc ysn fli
xyg: tps bpm cge
vjo: lfb agi hga
ufg: tiq qfk rth
mih: vje dmy
bjc: xyc tzf mfc
vry: svy hsy
xpx: vje rqx
kap: ski shw pdd
nfp: oqj puq tpe
frz: wyy
ver: mze voj
faz: out
jnn: okp fhe nfp jaa yqw uyo zsn zxs
jzr: lfj tsz waf ejs
vdp: ojx okd dpc
tiq: jnn xal wtz qqs fkf
yka: iza kzy
eeh: pen khf tmk
ncq: sdh
wtz: nxy hjx zsn yrw ztv okp nrk
rbw: ver pub wad
zxf: ouz xqu
ioy: rli xrt utp qbx xiq fkl xvj kbj gjp opx ujn zxh pqr bao jxj emh dbf awg pml jal
cxa: fkf xal
tsf: tyk dgd
fgu: jps pfl iki
dbk: ryk rda rbw
ski: nbz uxu eeh zpb
jqs: out
umv: eto
hpg: kai
brp: kgz yio
kmc: ury wzb
jub: upq
msw: lao xyg xvy
cpl: tyk dgd kxn
bwc: vuq spq
qvu: czt
aky: hva
pzx: xpu biu gjf dmo
rbe: lpm wzv
eno: sbh you wyy gui ydw
vzf: whl hml
qfj: oal kyk gno
vue: nhb
rul: yza
mvw: ilk kap ufo spf
blk: jwe
rui: gui ydw sbh wyy
cns: nmd
inp: njr vry
ncg: byv faz nwc
pfc: rsm onn
trq: sbh you wyy gui
dac: ltm fnt xyb
uio: nof kzd
vza: byv
ewp: hwx
lzb: ufo szj ilk
pvt: hua wtt yzs
ymz: acg azh
shw: nbz zpb
ddy: xbv
hxu: mah
qic: qwx bri bwc rfk
cgx: cei ipr
ffw: edt vry
tob: zqv jxj emh dbf awg pml jal gjp ujn utp qbx xiq fkl xvj kbj xrt wwe rli
urt: onc
joz: kfm upq msw
rxz: fex ncg
hvd: ury bzl wzb lob
vuq: gcg gao dkg
gui: mvw qfj kqw aej bjp idc eak zns bjc
edt: bxm hsy
ztv: dqy
pto: dmo biu gjf
ukx: hza lyh gqm
nwn: gro
wvz: xyb fnt ltm myu
ibs: dmy
koi: tiq pka qfk rth
tpe: xrc iea qil dpm
zpb: pen khf tmk
lfb: wef
ltm: ydw gui you wyy sbh
hza: pvt
smv: vwz wef
bri: vuq fft
dmh: jup bpf
fxa: pfl iki sdh jps
kzr: acg
kbb: zvn cvj
idc: xyc tzf viy mfc
dmo: yrm lbv nba
cvj: ktu
ilk: shw ill
bwp: iuk bgm
hwx: fvl ejy zpl
rqx: som pfw
mah: bon qjf
xpu: hxu lbv vqa yrm
bpv: you wyy ydw
joc: wyv kbb idw
ydw: eak lzb ges idc bbb aej bjc ehd jum wau mvw
ybo: wjw ury lob
sbh: max idc lzb afg bjp mvw
qqs: nrk qqv ztv yrw jaa pfc jlg
ras: jzr nkq pvn tsj
xvj: xro aan
zxg: ydw gui wyy
oys: ejy fvl zpl qum
jiz: iuk bgm
lyh: cgs wgb
fhe: ybh
jum: viy mfc tzf
dvp: czt
rlv: lob wjw ury
voj: czt pxb nhb
eto: rsq cxa wfn
ywy: out
azh: out
vko: nmd vjo
zyk: voj mze ipk
dgd: out
yqw: opq rnu
vbq: cxa
nrk: oqj puq fgi
ppe: ych rpp wef vwz
bop: okd rui ojx
pka: jnn wtz qqs fkf
ass: fex
ujn: bjw
qpb: xal qqs wtz fkf
qpf: gio pgm zxg frz
pgm: wyy you sbh ydw gui
sjk: ouz
fkf: yqd czz qqv lgd qvm yqw yrw ztv nfp zst zjy zxs hjx nxy zsn yka
som: hgw
ipk: czt pxb
xqu: oht kmc yda rlv
fgw: nhb
ndf: pvt cgs wgb
nbz: pen khf tmk
osi: rpp
okp: dqy xfc yro
mvp: pxb
jkz: caq svq ufg
kqw: aza kyk oal
eak: jiz bwp xlc
tyk: out
ijc: hwx
odo: mtx dej rzx bco
agi: ych rpp wef
env: rpp ych
vqa: szv dhw puc
xhf: ctu joz
awv: qum zpl
qbx: vpf qhd cxy ras
nkv: out
izk: dmo xpu
xgj: umv zye mha
iea: bpv ufc
vcg: vci hpg
pww: zii
kym: wyy you ydw
zye: ffx eto
pdd: uxu iru
hva: uio ktu bxx
hua: out
bjw: edt
rjn: gqs jzv rbe abn
hga: wef vwz
nfx: rpp
qil: kym bpv ufc
pqr: gwm tpk brp jdb
acg: out
vhk: jnn qqs
fgi: dpm qil xrc
wjw: urt qyq bxk ncq fxa khu
diz: tsz waf
qjf: pxb nhb
oiq: ijf dje ybo
hsy: lob ury wjw
cee: bon rqz
vhr: rbw
hvm: fxn jiz bwp
jaa: dac
rsm: ogr kqs
xeb: vzf
lgd: suq cxd
pml: kyo rty qmz
bco: ymz spr
gtt: fkf jnn xal
you: iks hvm qfj zns bjc afg bjp bbb max lzb
rcy: gjp utp emh bao qbx awg ujn jal kbj
oqj: qil dpm xrc
igc: okd rui
ctu: msw
okd: gui you wyy
gio: you
cch: pji
bpf: bop vdp
wef: ewp rjn pps izk ocs bzw dbk
wum: rrn
fxn: bgm iuk ukx
mbq: xqu bhu ouz
mzh: vbq
vva: aiw rnb
yrm: szv cee mah dhw puc
qwx: gaw spq vuq
egk: dmh suq cxd
rpp: iqh dbk pto pzx lte ewp qvq dur alp pps rxf gay uua ijc jrn ysn
jwe: qum
pxb: aqh xsp xgj cwn cvw whj fhg cgd lko lqo xhf scm met vtl qdh cjx jkz hpz
qrs: ppe fhw ihp jkf swq
ufo: ski pdd
myu: gui wyy
pfo: wyv
puc: qjf
khf: tfb zaf ywy tgx zyo
qvq: rda
vdn: pxb nhb
upq: xyg xvy mhd
xyc: odo wbj rez
jkf: rpp vwz
rjp: kxn tyk
pqv: lgs pmj
rqq: jwm pmj
aan: mmp ipr cei
gjf: yrm nba lbv hxu
waf: wjw wzb bzl lob
fex: nwc faz byv
jlg: dac wvz
tci: czt nhb
kyo: mbq hoc ozz
rjg: lpm
awg: cgx
jps: ddy zzk ari
dhw: bon rqz
ihk: mqz ass rxz
tsj: waf tsz ejs lfj hvd
szv: bon qjf
kxn: out
yio: gro oiq zfn
vju: ozz mbq sjk zxf
suq: bpf jup
ryk: rul ver wad pub zyk
mbm: jqs nkv azh
nwc: out
rnu: ogr
ddp: vhk qpb
svr: tob brz rcy nbi ioy
vjl: jlc
ijf: bzl wzb
pvw: zxg
bdo: wyy ydw
nmd: env agi lfb
pub: voj yza ipk
kvx: rnb rrn
cwn: leg rqq pqv
sjo: rzx mtx
iju: zzd gtt pmj
xsp: rqq
eae: vjo hlx
opx: vju qmz rty kyo
onc: xam nfx kai
zsn: dac wvz lda
xrt: brp
bwb: vpf
lob: ncq uzo hek urt jcl fgu fxa ftj vko hqz qyq cns vcg bxk qic
gro: dje ijf
xbv: jkf swq ihp fhw ppe
ijl: qvu mvp vdn
wad: yza voj ipk
zxs: rsm
scm: jub
ges: ilk kap
alp: oys awv hwx jwe
ftj: vci xlk hpg
jnm: dpc
lqo: zye umv
qum: wyt skj
ari: qrs xbv
rez: mtx hzj rzx bco
mfm: czt nhb
yro: nyv bdo
dmy: kwt som pfw
rqz: nhb
zii: hml ykk vjj whl
ehd: gno
yrw: suq
rty: hoc mbq zxf
dur: mih uzf ibs qcm
emh: aan
zqv: aan xro cgx
jxj: bjw inp utr iwv
nbi: zxh opx gjp jal dbf awg bao jxj emh zqv pqr xrt wwe fkl xvj qbx xiq utp bwb
dqy: nyv gxk lab trq
lgx: pgm eno
pdu: rpp vwz
wyy: afg wau max lzb jum hvm bjc zns
hoc: bhu
xsb: kcr rxz ass cjf
hho: zdu ijl
osa: uio
aza: hje
kfz: nhb pxb czt
cub: wef
zns: rob xeb
uyo: dac
mmp: wjw ury bzl wzb lob
jcl: rfk bri
mze: pxb
lab: sbh wyy
byv: out
lgs: fkf wtz qqs
yda: lob wjw wzb bzl
whj: leg
spf: pdd
kai: wef vwz ych
dkg: cub osi
svy: bzl wzb ury lob
vje: kwt
wau: kyk
gcg: hey cub osi
xfc: nyv bdo gxk trq
fkl: gwm jdb
wzb: fgu jcl hek eae ncq qic bxk qyq hqz khu fxa ftj
wfn: fkf qqs wtz xal jnn
bjp: vjl pro
hjx: xvz cxd
utr: njr vry
nyv: sbh gui ydw
kzy: huc kvx vva wum
jwm: qqs
lao: tps cge
bxm: wzb
ury: hek pfo eae uzo ncq fgu joc jcl urt khu gdn vko ftj fxa vcg qic bxk hqz cns
fkz: zdu
ffx: cxa rsq wfn
wwe: utr iwv inp
mhd: bpm cge
uca: zxg pgm frz gio eno
bxx: smv kzd nof
fhw: ych
xyb: ydw gui wyy sbh
cgs: hua
uzo: hpg byt onc
lda: myu xyb fnt ltm
spr: nkv jqs acg
tzf: odo wbj rez
nkq: hvd lfj waf ejs
bpm: xal jnn qqs wtz fkf
gay: biu gjf dmo
dje: wzb ury lob
gwm: kgz yio nwn
zxh: brp tpk gwm
ykk: rjp tsf cpl wph
fft: dkg gcg gao
tfb: out
pfw: mfm vue
mqz: fex vza xtk
xfz: jls dtk
whl: cpl tsf rjp
uxu: pen
qcm: dmy vje
bon: czt nhb
qhd: nkq pvn diz tsj
qdh: dtk ddp
afg: xlc fxn
rfk: kar fft vuq
wyt: nhb pxb
qqv: wvz dac
khu: bwc
gao: cub hey
cei: bzl
rsq: fkf jnn wtz
gxk: gui ydw sbh wyy
jls: qpb vhk
wzv: nhb czt pxb
ill: zpb uxu nbz
cxy: nkq pvn jzr tsj diz
iks: xyc viy
ktu: nof smv
biu: yrm
pfl: zzk ddy fgc jze
nba: szv cee
kbj: vpf cxy
tmk: ywy tfb zyo tgx
rli: iwv utr
dif: ury wzb bzl lob
bzd: opq rnu
jup: igc jnm vdp
